-----	-----	-----	-----	-----	-----	-----	-----	-----	-----	-----	-----	-----	-----	N0202	N0202	N0202	N0202	N0202	-----	-----	-----	-----	-----	-----	-----	-----	-----	-----	-----	-----	-----	-----
-----	-----	-----	-----	-----	-----	-----	-----	-----	-----	-----	-----	-----	N0203	N0203	N0203	N0203	N0203	N0203	N0203	-----	-----	-----	-----	-----	-----	-----	-----	-----	-----	-----	-----	-----
-----	-----	-----	-----	-----	-----	-----	-----	-----	-----	-----	-----	N0204	N0204	N0204	N0204	N0204	N0204	N0204	N0204	N0204	-----	-----	-----	-----	-----	-----	-----	-----	-----	-----	-----	-----
-----	-----	-----	-----	-----	-----	-----	-----	-----	-----	-----	N0205	N0205	N0205	N0205	N0205	N0205	N0205	N0205	N0205	N0205	N0205	-----	-----	-----	-----	-----	-----	-----	-----	-----	-----	-----
-----	-----	-----	-----	-----	-----	-----	-----	-----	-----	-----	N0205	N0205	N0205	N0205	N0205	N0205	N0205	N0205	N0205	N0205	N0205	-----	-----	-----	-----	-----	-----	-----	-----	-----	-----	-----
-----	-----	-----	-----	-----	-----	-----	-----	-----	-----	-----	N0205	N0205	N0205	N0205	N0205	N0205	N0205	N0205	N0205	N0205	N0205	-----	-----	-----	-----	-----	-----	-----	-----	-----	-----	-----
-----	-----	-----	N0205	N0205	N0205	N0205	N0205	N0205	N0205	N0205	N0205	N0205	N0205	N0205	N0205	N0205	N0205	N0205	N0205	N0205	N0205	N0205	N0205	N0205	N0205	N0205	N0205	N0205	N0205	-----	-----	-----
-----	-----	-----	N0205	N0205	N0205	N0205	N0205	N0205	N0205	N0205	N0205	N0205	N0205	N0205	N0205	N0205	N0205	N0205	N0205	N0205	N0205	N0205	N0205	N0205	N0205	N0205	N0205	N0205	N0205	-----	-----	-----
N0200	N0200	N0200	N0205	N0205	M0105	N0205	N0205	P0105	P0105	P0105	P0105	P0105	P0105	P0105	P0105	P0105	P0105	P0105	P0105	P0105	P0105	P0105	P0105	P0105	N0205	N0205	M0105	N0205	N0205	N0200	N0200	N0200
N0201	W0201	N0201	N0205	N0205	M0105	M0105	N0205	N0205	P0105	P0105	P0105	P0105	P0105	P0105	W0205	W0205	W0205	P0105	P0105	P0105	P0105	P0105	P0105	N0205	N0205	M0105	M0105	N0205	N0205	N0201	W0201	N0201
N0202	W0202	N0202	N0205	N0205	M0105	M0105	M0105	N0205	N0205	P0105	P0105	P0105	P0105	P0105	P0105	P0105	P0105	P0105	P0105	P0105	P0105	P0105	N0205	N0205	M0105	M0105	M0105	N0205	N0205	N0202	W0202	N0202
N0203	W0202	N0203	N0205	N0205	M0105	M0105	M0105	M0105	N0205	N0205	N0205	N0205	N0205	N0205	N0205	N0205	N0205	N0205	N0205	N0205	N0205	N0205	N0205	M0105	M0105	M0105	M0105	N0205	N0205	N0203	W0203	N0203
N0204	W0204	N0204	N0205	N0205	M0105	M0105	M0105	M0105	M0105	N0205	N0205	P0106	P0106	P0106	W0206	W0206	W0206	P0106	P0106	P0106	N0205	N0205	M0105	M0105	M0105	M0105	M0105	N0205	N0205	N0204	W0204	N0204
N0205	W0205	N0205	N0205	N0205	M0105	M0105	M0105	M0105	M0105	M0105	N0205	N0205	P0106	W0206	W0206	N0206	W0206	W0206	P0106	N0205	N0205	M0105	M0105	M0105	M0105	M0105	M0105	N0205	N0205	N0205	W0205	N0205
N0206	W0206	N0206	N0205	N0205	N0205	N0205	N0205	N0205	N0205	N0205	N0205	N0205	W0205	P0106	W0206	W0206	W0206	P0106	W0205	N0205	N0205	N0205	N0205	N0205	N0205	N0205	N0205	N0205	N0205	N0206	W0206	N0206
N0206	W0206	W0206	W0205	W0205	W0205	W0205	W0205	W0205	W0205	W0205	W0205	W0205	N0205	N0205	P0106	W0206	P0106	N0205	N0205	W0205	W0205	W0205	W0205	W0205	W0205	W0205	W0205	W0205	W0205	W0206	W0206	N0206
N0206	N0206	N0206	N0205	N0205	N0205	N0205	N0205	N0205	N0205	N0205	N0205	N0205	N0205	N0205	N0205	W0205	N0205	N0205	N0205	N0205	N0205	N0205	N0205	N0205	N0205	N0205	N0205	N0205	N0205	N0206	W0206	N0206
-----	-----	-----	N0205	N0205	F0405	P0105	F0405	P0105	F0405	P0105	F0405	P0105	F0405	P0105	N0205	W0205	N0205	F0405	P0105	F0405	P0105	F0405	P0105	F0405	P0105	F0405	P0105	N0205	N0205	-----	-----	-----
-----	-----	-----	N0205	N0205	N0205	F0405	P0105	F0405	P0105	F0405	P0105	F0405	P0105	F0405	N0205	W0205	N0205	P0105	F0405	P0105	F0405	P0105	F0405	P0105	F0405	P0105	N0205	N0205	N0205	-----	-----	-----
-----	-----	-----	N0205	N0205	N0205	N0205	F0405	P0105	F0405	P0105	F0405	P0105	F0405	P0105	N0205	W0205	N0205	F0405	P0105	F0405	P0105	F0405	P0105	F0405	P0105	N0205	N0205	N0205	N0205	-----	-----	-----
-----	-----	-----	-----	N0205	N0205	N0205	N0205	F0405	P0105	F0405	P0105	F0405	P0105	F0405	N0205	W0205	N0205	P0105	F0405	P0105	F0405	P0105	F0405	P0105	N0205	N0205	N0205	N0205	-----	-----	-----	-----
-----	-----	-----	-----	-----	N0205	N0205	N0205	N0205	F0405	P0105	F0405	P0105	F0405	P0105	N0205	W0205	N0205	F0405	P0105	F0405	P0105	F0405	P0105	N0205	N0205	N0205	N0205	-----	-----	-----	-----	-----
-----	-----	-----	-----	-----	-----	N0205	N0205	N0205	N0205	N0205	N0205	N0205	N0205	N0205	N0205	W0205	N0205	N0205	N0205	N0205	N0205	N0205	N0205	N0205	N0205	N0205	-----	-----	-----	-----	-----	-----
-----	-----	-----	-----	-----	-----	-----	-----	-----	N0200	N0201	N0202	N0203	N0204	N0205	N0206	W0206	N0206	N0205	N0204	N0203	N0202	N0201	N0200	-----	-----	-----	-----	-----	-----	-----	-----	-----
-----	-----	-----	-----	-----	-----	-----	-----	-----	N0200	W0201	W0202	W0203	W0204	W0205	W0206	W0206	W0206	W0205	W0204	W0203	W0202	W0201	N0200	-----	-----	-----	-----	-----	-----	-----	-----	-----
-----	-----	-----	-----	-----	-----	-----	-----	-----	N0200	N0201	N0202	N0203	N0204	N0205	N0206	N0206	N0206	N0205	N0204	N0203	N0202	N0201	N0200	-----	-----	-----	-----	-----	-----	-----	-----	-----