M0300	M0300	M0300	M0300	M0300	P0101	M0300	M0300	M0300	M0300	M0300	M0300	M0300	M0300	M0300	M0300	M0300	M0300	M0300	M0300	M0300
M0300	P0101	P0101	P0101	M0300	P0101	P0101	M0300	M0300	M0300	M0300	M0300	M0300	M0300	N0201	N0201	N0201	N0201	N0201	M0300	M0300
M0300	P0101	P0100	P0101	M0300	M0300	P0101	P0101	M0300	M0300	M0300	M0300	M0300	M0300	N0201	W0200	W0200	W0200	N0201	M0300	M0300
M0300	P0101	P0100	P0101	P0101	M0300	M0300	P0101	P0101	P0101	M0300	M0300	M0300	M0300	N0201	W0200	W0200	W0200	N0201	M0300	M0300
M0300	P0101	P0100	P0100	P0101	P0101	M0300	M0300	M0300	P0101	M0300	M0300	M0300	M0300	N0201	W0200	W0200	W0200	N0201	M0300	M0300
M0300	P0101	P0100	P0100	P0100	P0101	P0101	P0101	M0300	P0101	M0300	M0300	M0300	M0300	N0201	W0200	W0200	W0200	N0201	M0300	M0300
M0300	P0101	P0101	P0100	P0100	P0100	P0100	P0101	M0300	P0101	M0300	M0300	M0300	M0300	N0201	W0200	W0200	W0200	N0201	M0300	M0300
M0300	M0300	P0101	P0101	P0101	P0101	P0101	P0101	M0300	P0101	M0300	M0300	M0300	M0300	N0201	W0200	W0200	W0200	N0201	M0300	M0300
M0300	M0300	M0300	M0300	M0300	M0300	M0300	M0300	M0300	M0300	M0300	M0300	M0300	M0300	N0201	W0200	W0200	W0200	N0201	M0300	M0300
M0300	M0300	P0101	P0101	P0101	P0101	P0101	P0101	M0300	P0101	M0300	M0300	M0300	M0300	N0201	W0200	W0200	W0200	N0201	M0300	M0300
M0300	P0101	P0101	P0100	P0100	P0100	P0100	P0101	M0300	P0101	M0300	M0300	M0300	M0300	N0201	W0200	W0200	W0200	N0201	M0300	M0300
M0300	P0101	P0100	P0100	P0100	P0101	P0101	P0101	M0300	P0101	M0300	M0300	M0300	M0300	N0201	W0200	W0200	W0200	N0201	M0300	M0300
M0300	P0101	P0100	P0100	P0101	P0101	M0300	M0300	M0300	P0101	M0300	M0300	M0300	M0300	N0201	W0200	W0200	W0200	N0201	M0300	M0300
M0300	P0101	P0100	P0101	P0101	M0300	M0300	P0101	P0101	P0101	M0300	M0300	M0300	M0300	N0201	W0200	W0200	W0200	N0201	M0300	M0300
M0300	P0101	P0100	P0101	M0300	M0300	P0101	P0101	M0300	M0300	M0300	M0300	M0300	M0300	N0201	W0200	W0200	W0200	N0201	M0300	M0300
M0300	P0101	P0101	P0101	M0300	P0101	P0101	M0300	M0300	M0300	M0300	M0300	M0300	M0300	N0201	N0201	N0201	N0201	N0201	M0300	M0300
M0300	M0300	M0300	M0300	M0300	P0101	M0300	M0300	M0300	M0300	M0300	M0300	M0300	M0300	M0300	M0300	M0300	M0300	M0300	M0300	M0300
