-	-	P0400	P0400	P0400	P0400	P0400	P0400	P0400	P0601	P0400	-	-
-	-	P0601	P0601	P0400	P0400	P0400	P0400	P0400	P0601	P0400	-	-
-	-	M0500	M0500	P0601	M0500	P0400	M0500	M0500	P0400	P0400	-	-
-	-	M0500	M0500	P0400	M0500	P0400	P0400	P0400	P0601	P0400	-	-
-	-	P0400	P0400	P0400	P0400	P0400	P0400	P0400	P0400	P0400	-	-
-	-	P0400	P0601	M0500	P0400	M0500	M0500	P0400	P0400	M0500	-	-
-	-	P0400	P0601	P0400	P0400	P0400	P0400	M0500	P0400	M0500	-	-
-	-	P0400	P0400	P0400	P0400	P0400	P0400	M0500	P0400	M0500	-	-
-	-	M0500	P0601	P0601	P0400	P0400	P0400	P0400	P0400	P0601	-	-
-	-	M0500	M0500	P0400	P0400	P0400	P0400	P0400	M0500	M0500	-	-
P0400	P0400	P0400	P0400	P0400	P0400	P0400	P0400	P0400	P0400	P0400	P0400	P0400
P0400	P0601	P0400	P0400	P0400	P0400	P0400	P0400	P0400	P0400	P0400	P0601	P0400
P0400	P0400	P0400	P0400	P0400	P0400	P0400	P0400	P0400	P0400	P0400	P0601	P0400
P0400	P0400	P0601	P0601	P0400	P0400	P0400	P0400	P0601	P0400	P0400	P0400	P0400
P0602	P0401	P0400	P0400	P0400	P0400	P0400	P0400	P0601	P0400	P0400	P0401	P0602
P0602	P0401	P0400	P0400	P0400	P0400	P0601	P0400	P0400	P0400	P0400	P0401	P0602
P0401	P0401	P0401	P0401	P0401	P0401	P0401	P0401	P0401	P0401	P0401	P0401	P0401
P0401	P0401	P0401	P0401	P0401	P0401	P0401	P0401	P0401	P0602	P0602	P0401	P0401
P0602	P0602	P0401	P0401	P0401	P0401	P0401	P0401	P0401	P0401	P0401	P0401	P0401
P0401	P0401	P0401	P0401	P0602	P0401	P0401	P0401	P0401	P0401	P0401	P0602	P0602
P0401	P0401	P0401	P0401	P0602	P0401	P0401	P0602	P0401	P0401	P0401	P0401	P0401
P0401	P0401	P0401	P0401	P0401	P0401	P0401	P0602	P0401	P0401	P0401	P0401	P0401
